1
0.5
-8
12
-7
15
001111111111111111111
001000000000000111111
001000000000001100011
001000000000011000011
001000000000000000011
001000000000000000011
001000000000000000001
001000001000000000101
001000011000000000101
001000010000000000001
001000010000000000001
001000010000000000001
001000010000000000001
001000010000000000001
001000000000000000001
001000000111100000001
001000001111111000001
001000001111111000001
001000001111111000001
001000000000000000001
001000000000000000001
001111111111111111111
000000000000000000000
