-12
16
-6
9
00000000000000000000000000000
00000000000000000000000000000
00000000000000000000000000000
11111111111111111111111111000
00000000000000000000000001000
00000000000000000000000001000
00000000000000000000000001000
00000000000000000111111101000
00000000000000000111111101000
00000000000000000111111101000
00000000000000000111111101000
00000000000000010111111101000
00000000000000000111011101000
00000000000000000111011101000
00000000000000000000000001000
00000000000000000000000001000
