1
0.5
-8
12
-7
15
111111111111111111111
111000000000000111111
111000000000001100011
111000000000011000011
111000000000000000011
111000000000000000011
111000000000000000001
111000001000000000101
111000011000000000101
111000010000000000001
111000010000000000001
111000010000000000001
111000010000000000001
111000010000000000001
111000000000000000001
111000000111100000001
111000001111111000001
111000001111111000001
111000001111111000001
111000000000000000001
111000000000000000001
111111111111111111111
111111111111111111111
