{
"maps": [
  {
    "id": 1,
    "cellWidth": 1.0,
    "cellHeight": 0.5,
    "cellBoundMinX": -8,
    "cellBoundMaxX": 12,
    "cellBoundMinY": -7,
    "cellBoundMaxY": 15,
    "collisions": [
      "111111111111111111111",
      "111000000000000111111",
      "111000000000001100011",
      "111000000000011000011",
      "111000000000000000011",
      "111000000000000000011",
      "111000000000000000001",
      "111000001000000000101",
      "111000011000000000101",
      "111000010000000000001",
      "111000010000000000001",
      "111000010000000000001",
      "111000010000000000001",
      "111000010000000000001",
      "111000000000000000001",
      "111000000111100000001",
      "111000001111111000001",
      "111000001111111000001",
      "111000001111111000001",
      "111000000000000000001",
      "111000000000000000001",
      "111111111111111111111",
      "111111111111111111111"
    ],
    "teleports": [
      {
        "number": 0,
        "clientPosX": -7.91,
        "clientPosY": 2.648
      },
      {
        "number": 1,
        "clientPosX": 6.311,
        "clientPosY": 1.919
      }
    ]
  },
  {
    "id": 2,
    "cellWidth": 1.0,
    "cellHeight": 0.5,
    "cellBoundMinX": -8,
    "cellBoundMaxX": 12,
    "cellBoundMinY": -7,
    "cellBoundMaxY": 15,
    "collisions": [
      "111111111111111111111",
      "111000000000000111111",
      "111000000000001100011",
      "111000000000011000011",
      "111000000000000000011",
      "111000000000000000011",
      "111000000000000000001",
      "111000001000000000101",
      "111000011000000000101",
      "111000010000000000001",
      "111000010000000000001",
      "111000010000000000001",
      "111000010000000000001",
      "111000010000000000001",
      "111000000000000000001",
      "111000000111100000001",
      "111000001111111000001",
      "111000001111111000001",
      "111000001111111000001",
      "111000000000000000001",
      "111000000000000000001",
      "111111111111111111111",
      "111111111111111111111"
    ],
    "teleports": [
      {
        "number": 0,
        "clientPosX": -7.91,
        "clientPosY": 2.648
      },
      {
        "number": 1,
        "clientPosX": 6.311,
        "clientPosY": 1.919
      }
    ]
  }
]
}