-12
12
-6
6
0000000000000000000000000
0000000000000000000000000
0000000000000000000000000
0000000000000000000000000
0000000000000000011111110
0000011111100000011111110
0000011111100000011111110
0000011111100000011111110
0000011111100001011111110
0000000000000000011101110
0000000000000000011101110
0000000000000000000000000
0000000000000000000000000
